{
    "ini": {
        "幫母": "",
        "滂母": "",
        "並母": "",
        "明母": "",
        "端母": "",
        "透母": "",
        "定母": "",
        "泥母": "",
        "來母": "",
        "知母": "",
        "徹母": "",
        "澄母": "",
        "孃母": "",
        "精母": "",
        "清母": "",
        "從母": "",
        "心母": "",
        "邪母": "",
        "莊母": "",
        "初母": "",
        "崇母": "",
        "生母": "",
        "俟母": "",
        "章母": "",
        "昌母": "",
        "常母": "",
        "書母": "",
        "船母": "",
        "日母": "",
        "見母": "",
        "溪母": "",
        "羣母": "",
        "疑母": "",
        "影母": "",
        "曉母": "",
        "匣母": "",
        "云母": "",
        "以母": ""
    },
    "niu": {
        "A紐": "",
        "B紐": ""
    },
    "rime": {
        "一東韻": "",
        "三東韻": "",
        "冬韻": "",
        "鍾韻": "",
        "江韻": "",
        "支韻": "",
        "脂韻": "",
        "之韻": "",
        "微韻": "",
        "魚韻": "",
        "虞韻": "",
        "模韻": "",
        "齊韻": "",
        "祭韻": "",
        "泰韻": "",
        "佳韻": "",
        "皆韻": "",
        "夬韻": "",
        "灰韻": "",
        "咍韻": "",
        "廢韻": "",
        "眞韻": "",
        "臻韻": "",
        "文韻": "",
        "欣韻": "",
        "元韻": "",
        "魂韻": "",
        "痕韻": "",
        "寒韻": "",
        "刪韻": "",
        "山韻": "",
        "先韻": "",
        "仙韻": "",
        "蕭韻": "",
        "宵韻": "",
        "肴韻": "",
        "豪韻": "",
        "一歌韻": "",
        "三歌韻": "",
        "二麻韻": "",
        "三麻韻": "",
        "陽韻": "",
        "唐韻": "",
        "二庚韻": "",
        "三庚韻": "",
        "耕韻": "",
        "清韻": "",
        "青韻": "",
        "蒸韻": "",
        "登韻": "",
        "尤韻": "",
        "侯韻": "",
        "幽韻": "",
        "侵韻": "",
        "覃韻": "",
        "談韻": "",
        "鹽韻": "",
        "添韻": "",
        "咸韻": "",
        "銜韻": "",
        "嚴韻": "",
        "凡韻": ""
    },
    "tone": {
        "ㄥ尾": "",
        "ㄟ尾": "",
        "ㄡ尾": "",
        "ㄣ尾": "",
        "nan尾": "",
        "ㄇ尾": ""
    },
    "coda": {
        "平聲": "",
        "上聲": "",
        "去聲": "",
        "入聲": ""
    }
}